R 600 600

NO ./textures/ex.png
SO ./textures/ex.png
WE ./textures/ex.png
EA ./textures/ex.png

S ./textures/ex.png

F 0,10,0
C 225,30,0

11111111111111111111
10000000000000000001
10000000011100000001
10000000010000000001
10000111100000011111
111111  11111111
//old gnl is shit, that why its here