.! Map trying everything

R 1920 1080

NO res/wall_n.xpm
SO res/wall_s.xpm
WE res/wall_w.xpm
EA res/wall_e.xpm
S res/a coin.xpm

F 51,46,96
C 239,238,143

.. Bonus parameters

DE 0 Ghost 0 100 res/spr_tex_a.xpm
DE 1 Coin 0 100 res/a coin.xpm
DE 2 Mask 1 100 res/angry_mask.xpm
DE 3 Vampire 1 100 res/green_vampire.xpm
IT 0 -50
IT 1 10
HP 75

111111111111111111111111111111111111111111111111111111111111111111111
100000000000000000000000000000000000000000000000000000000000000000001
100000000000000000000000000000000000000000000000000000000000000000001
100000000000000000000000000000000000000000000000000000000000000000001
100000000000000000000000000000000000000000000000000000000000000000001
100000000000000000000000000000000000000000000000000000000000000000001
100000000000000000000000000000000000000000000000000000000000000000001
100000000000000000000000000000000000000000000000000000000000000000001
100000000000000000000000000000000000000000000000000002000000000000001
100000000000000000000000000000000000000000000000000000000000000000001
100000000000000000000001111111111111111100000000000000000000000000001
100000000000000000000001000000000000000100000000000000000000000000001
100000000000000000000001000000000000000100000000000000000000000000001
100000002000000000000001000000000000000100000000000000000000000000001
100000000000000000000001000000000000000100000000000000000000000000001
10000000000000000000000100 A B C D 0000100000000000000000000000000001
100000000000000000000001000000000000000100000000000000000000000000001
100000000000000000000001000000N00000000100000000000000000000000000001
100000000000000000000001000000000000000100000000000000000000000000001
100000000000000000000001ABC111111111111100000000000000000000000000001
100000000000000000000001000000000000000100000000000000000000000000001
1000000000000000000000010000C0000000000100000000000000000000000000001
100000000000000000000001111101110010D00100000000000000000000000000001
100000000200000000200001000000000000000100000000000000000000000000001
100000000000000000000001000000000000000100000000000000000000000000001
100000000000000000000001000000000000000100000000000000000000000000001
100000000000000000000001000000000000000100000000000000000000000000001
100000000000000000000001000000000000000100000000000000000000000000001
100000000000000000000001000000000000000100000000000000000000000000001
100000000000000000000001111111111111110100000000000000000000000000001
100000000000000000000000000000000000000000000000000000000000000000001
100000000000000000000000000000000000000000000000000000000000000000001
100000000000000000000000000000000000000000000000000000000000000000001
100000000000000000000000000000000000000000000000000000000000000000001
100000000000000000000000000000000000000000000000000000000000000000001
100000000000000000000000000000000000000000000000000000000000000000001
100000000000000000000000000000000000000000000000000000000000000000001
100000000000000000000000000000000000000000000000000000000000000000001
100000000000000000000000000000000000000000000000000000000000000000001
100000000000000000000000000000000000000000000000000000000000000000001
100000000000000000000000000000000000000000000000000000000000000000001
100000000000000000000000000000000000000000000000000000000000000000001
100000000000000000000000000000000000000000000000000000000000000000001
100000000000000000000000000000000000000000000000000000000000000000001
100000000000000000000000000000000000000000000000000000000000000000001
100000000000000000000000000000000000000000000000000000000000000000001
100000000000000000000000000000000000000000000000000000000000000000001
100000000000000000000000000000000000000000000000000000000000000000001
100000000000000000020000000000000000200000000000000000000000000000001
100000000000000000000000000000000000000000000000000000000000000000001
100000000000000000000000000000000000000000000000000000000000000000001
100000000000000000000000000000000000000000000000000000000000000000001
100000000000000000000000000000000000000000000000000000000000000000001
100000000000000000000000000000000000000000000000000000000000000000001
100000000000000000000000000000000000000000000000000000000000000000001
100000000000000000000000000000000000000000000000000000000000000000001
100000000000000000000000000000000000000000000000000000000000000000001
100000000000000000000000000000000000000000000000000000000000000000001
100000000000000000000000000000000000000000000000000000000000000000001
100000000000000000000000000000000000000000000000000000000000000000001
100000000000000000000000000000000000000000000000000000000000000000001
100000000000000000000000000000000000000000000000000000000000000000001
100000000000000000000000000000000000000000000000000000000000000000001
100000000000000000000000000000000000000000000000000000000000000000001
100000000000000000000000000000000000000000000000000000000000000000001
100000000000000000000000000000000000000000000000000000000000000000001
100000000000000000000000000000000000000000000000000000000000000000001
100000000000000000000000000000000000000000000000000000000000000000001
100000000000000000000000000000000000000000000000000000000000000000001
100000000000000000000000000000000000000000000000000000000000000000001
100000000000000000000000000000000000000200000000000000000000000000001
100000000000000000000000000000000000000000000000000000000000000000001
100000000000000000000000000000000000000000000000000000000000000000001
100000000000000000000000000000000000000000000000000000000000000000001
100000000000000000000000000000000000000000000000000000000000000000001
100000000000000000000000000000000000000000000000000000000000000000001
100000000000000000000000000000000000000000000000000000000000000000001
100000000000000000000000000000000000000000000000000000000000000000001
100000000000000000000000000000000000000000000000000000000000000000001
100000000000000000000000000000000000000000000000000000000000000000001
100000000000000000000000000000000000000000000000000000000000000000001
100000000000000000000000000000000000000000000000000000000000000000001
111111111111111111111111111111111111111111111111111111111111111111111
