R 600 600

NO ./textures/ex.png
SO ./textures/ex.png
WE ./textures/ex.png
EA ./textures/ex.png

S ./textures/ex.png

F 0,10,0
C 225,30,0

111111
100101
102001
1100N100
111111
//old gnl is shit, that why its here